R 831 855
F 123,123,123
NO ./textures/brick.xpm
WE ./textures/stone.xpm
EA ./textures/wood.xpm
SO ./textures/metal.xpm
S ./textures/barrel.xpm
C 32,32,32

111111111111111  1111111111111
100000000000001  1222200000001
100000000000001  1000000000001
10000N000000021  1000000000001
100000000000001  1000000000001
100000000000001111000000000001 1111111
111111111000000000000000000001 1000001
        1000000000000000000001 1000001
111111111000000000000111111111 1000001
1000000000000000000001         1111111
1000000000000000000001
1000000000000000200001
1111111111000000000001
         1000000000001
         1000000000001
         1111111111111